soweit	NOTYET
allerdings	CONCESSION
da	JOINT
dann	SEQUENCE
hiernach	SEQUENCE
dadurch	ELABORATION
weder	NOTYET
anstelle dessen	ASYMMETRIC CONTRAST
dagegen	CONTRAST
ansonsten	CONTRAST
bevor	SEQUENCE
also	CAUSE
sodann	SEQUENCE
vorausgesetzt , dass	CONDITION
vorausgesetzt , daß	CONDITION
obgleich	CONCESSION
obendrein	ELABORATION
weiterhin	ELABORATION
ausserdem	CIRCUMSTANCE
außerdem	CIRCUMSTANCE
infolgedessen	CAUSE
sonst	NOTYET
inzwischen	SEQUENCE
folglich	CAUSE
andererseits	CONTRAST
anstatt	CONTRAST
weshalb	CAUSE
ebenso wenig	ELABORATION
aufgrund	CAUSE
dennoch	CONCESSION
nebenher	JOINT
hierdurch	CAUSE
dabei	ELABORATION
desgleichen	ELABORATION
zuvor	SEQUENCE
ausser , dass	CONCESSION
ausser , daß	CONCESSION
außer , daß	CONCESSION
hingegen	CONTRAST
womit	NOTYET
allein	CONTRAST
darauf	SEQUENCE
sodass	CAUSE
sodaß	CAUSE
sofern	CONDITION
nur , dass	CONCESSION
nur , daß	CONCESSION
soeben	NOTYET
deshalb	CAUSE
dessen ungeachtet	CONCESSION
zugleich	JOINT
obwohl	CONCESSION
später	SEQUENCE
beispielsweise	ELABORATION
zusätzlich	ELABORATION
wegen	CAUSE
ohnehin	ELABORATION
vorher	NOTYET
nichtsdestoweniger	CONCESSION
trotzdem	CONCESSION
ferner	ELABORATION
hierauf	SEQUENCE
statt	NOTYET
nämlich	ELABORATION
ob	NOTYET
wonach	SEQUENCE
während	JOINT
weswegen	CAUSE
darüber hinaus	ELABORATION
zumal	CAUSE
nachdem	PRECONDITION
so oder so	ELABORATION
trotz	CONCESSION
wie	SEQUENCE
deswegen	CAUSE
wenn	NOTYET
des weiteren	ELABORATION
beziehungsweise	ELABORATION
ergo	CAUSE
inwieweit	ELABORATION
unterdessen	JOINT
zunächst	SEQUENCE
ohnedies	ELABORATION
falls	CONDITION
doch	ELABORATION
infolge	CAUSE
woraufhin	SEQUENCE
ausser wenn	CONCESSION
außer wenn	CONCESSION
zum Beispiel	ELABORATION
zu dem Beispiel	ELABORATION
warum	ELABORATION
daher	CAUSE
demgegenüber	CONTRAST
ebenfalls	ELABORATION
wogegen	CONTRAST
mithin	CAUSE
seit	NOTYET
überdies	ELABORATION
denn	CAUSE
obzwar	CONCESSION
entgegen	CONTRAST
inwiefern	ELABORATION
zudem	ELABORATION
seither	NOTYET
zwar	CONCESSION
ausser	CONCESSION
außer	CONCESSION
so	ELABORATION
aus diesem Grund	CAUSE
daraufhin	SEQUENCE
allenfalls	ELABORATION
darum	CAUSE
wenngleich	CONCESSION
als	CIRCUMSTANCE
somit	CAUSE
weil	CAUSE
indem	MEANS
insofern	MEANS
währenddessen	NOTYET
gleichwohl	CONCESSION
andernfalls	CONTRAST
dafür	CONTRAST
danach	SEQUENCE
worauf	SEQUENCE
sobald	SEQUENCE
seitdem	NOTYET
obschon	CONCESSION
aber	CONTRAST
sondern	CONTRAST
vielmehr	ASYMMETRIC CONTRAST
wenn auch	CONCESSION
auch wenn	CONCESSION
